00000000000000000000000000000000
00003000000000000333000000030000
00000000300003000313000003000000
03000000000000000333000003000000
00000000030000000111000000000000
00300003333300000220000000000000
00000000030001111220000003000000
01111000000011111110000003000000
01111100000011111100000000000000
01111100300011111100000011111100
01111100300011111222222211111100
02202200000021111122222211111100
02202200000011111100000011111100
02202200000001111100000000000000
02222222222011113100300000030000
02222222222111133300000000030000
00000000011111113100000000000000
00300000000111111100300000000000
00000030003000000000300000300000
00030000000000300000000000003000