000000000000000000
000000001100000000
000000011110000000
000000111111000000
000001111111100000
001111110011111100
001111110011111100
001111111111111100
001100111111001100
001100111111001100
001111111111111100
001111110011111100
001111110011111100
001111111111111100
000001100001100000
000001100001100000
000111111111111000
000111111111111000
000111111111111000
000000000000000000