222222222222222222222222
211111111111111111101112
222110111111111111201112
111111011111111111101112
222110111112211111101112
212111111122221111110112
212222111111111111110112
212222111111131111111112
222111111111111110111112
000001113111111110111112
011101111011101110000002
013101111100011111111112
011101311110111011112112
001111111310311111111112
001111111111111011110112
210011111111111111111112
211111111211112111112112
211111111111111111122222
222221111111111112222222
222222111111111111122222